[info]
origen=terrenogen.png
mapa=.....................
     .......____..........
     .......____..........
     .....................
     .....................
     ...............__....
     ...............__....
     ..__.........______..
     ..__.........______..
     .....................