[info]
origen=terrenogen.png
mapa=...............__....
     .......____....__....
     __.....____....__....
     __...................
     ...._................
     .......__.....__.....
     .......__......__....
     ..__...__....______..
     ..__...__...______...
     .......__............