[info]
origen=terrenogen.png
mapa=.....................
     ...._____________....
     ...._____________....
     .....................
     .....................
     ..........__.........
     ..........__.........
     ..__....______...__..
     ..__....______...__..
     .....................