[info]
origen=terrenogen.png
mapa=.....................
     .......____....__....
     __.....____....__....
     __.............__....
     ...._................
     .......__.....__.....
     .......__......__....
     ..__...__....______..
     ..__...__...______...
     .......__............