[info]
origen=terrenogen.png
mapa=_____________________
     _____________________
     ___......___......___
     ___......___......___
     ___...............___
     ___...............___
     ___......___......___
     ___......___......___
     _____________________
     _____________________